┌───┬───────────────────┬───────────────────┬───┐ 
│   │                   │                   │   │ 
│   └───────┐   ┌───────┘   │   ┌───┬────   │   │ 
│           │   │           │   │   │       │   │ 
├───────┐   │   │   ────┬───┤   │   │   ────┘   │ 
│       │   │           │   │   │   │           │ 
│   │   │   └───────┐   │   │   │   └───────┐   │ 
│   │   │           │       │   │           │   │ 
│   ├───┴────────   ├────   │   └───┐   ────┘   │ 
│   │               │       │       │           │ 
│   │   ┌───────────┴───┐   └───┐   │   ────────┤ 
│       │               │       │   │           │ 
│   ┌───┴────   ┌────   ├────   │   ├───────┐   │ 
│   │           │       │       │   │       │   │ 
│   │   ┌───────┘   ────┴───────┘   │   ────┘   │ 
│       │                           │           │ 
└───────┴───────────────────────────┴───────────┘ 